******************************
******************************
******************************
***########################***
***#**********************#***
***#*####################*#***
***#*#******************#*#***
***#*#*################*#*#***
***#*#*#*******#******#*#*#***
***#*#*#*############*#*#*#***
***#*#*#*#**********#*#*#*#***
***#*#*#*#*########*#*#*#*#***
***#*#*#*#*#******#*#*#*#*#***
***#*#*#*#*#******###*#*#*#***
***#*#*#*#*#**###*#*#*#*#*#***
***###*#*#*#**#*e*#*#*#*#*#***
***#*#*#*#*#**#***#*#*#*#*#***
***#*#*#*#*#**#***#*#*#*#*#***
***#*#*#*#*########*#*#*#*#***
***#*#*#*#**********#*#*#*#***
***#*#*#*############*#*#*#***
***#*#*#**************#*#*#***
***#*#*################*#*#***
***#*#*****#************#*#***
***#*####################*#***
***#**********************#***
***############.###########***
***************l**************
******************************
******************************
******************************