*********************************
*###*#########**#*#*###*####**#**
*#*#****#*#**#*######*#***#**##**
*#*#*##***#*####*#**#*###*#*##***
*#*#**#####****#***####*#######**
*#*##**#########*###*#***##**#***
*#*###*******#*#*##****#***#*##**
*#*#*#######******#*##########***
***#*****#*#*####*#**#**#*##*##**
*###*###*#****#*####*####*****#**
*#*#***####*###**#*#**#**####****
*#*###*#*#***###*#*#*#####**#*#**
***#*****#*#*#*#*#*#*******####**
*###*#######*#*#######*#*###**#**
*#***#*****#***##******###*##*#e*
*#*###*###*###*#**####**#***##***
*#***###****##***##**##***#**##**
*###*****##*#**#**##**######**#**
***######*#######**##*#***#####**
*#**#***###****###**#***#*#***#**
*######*****##*#*##**######*#*#**
**#*****###*#**#**##***#**###****
*####*###*###*###*#**####*#*###**
*#**#**#**#*#***###*##**#****#***
*##*#####***###***#*#**###*#*##**
*#**#*#*###***########*#*#*#**#**
*######***#*#****#***###*####*#**
***#**###*########*#*#***#**#*#**
*###*##*****#****#*#######*####**
*#****####*###*#*###***#*###**#**
*####**#*###*###*#*#####**#**##**
*****************.***************
*****************l***************
*********************************
