********************************
*###*#########**#*#*###*####**#*
*#*#****#*#**#*######*#***#**##*
*#*#*##***#*####*#**#*###*#*##**
*#*#**#####****#***####*#######*
*#*##**#########*###*#***##**#**
*#*###*******#*#*##****#***#*##*
*#*#*#######******#*##########**
***#*****#*#*####*#**#**#*##*##*
*###*###*#****#*####*####*****#*
*#*#***####*###**#*#**#**####***
*#*###*#*#***###*#*#*#####**#*#*
***#*****#*#*#*#*#*#*******####*
*###*#######*#*#######*#*###**#*
*#***#*****#***##******###*##*#e
*#*###*###*###*#**####**#***##**
*#***###****##***##**##***#**##*
*###*****##*#**#**##**######**#*
***######*#######**##*#***#####*
*#**#***###****###**#***#*#***#*
*######*****##*#*##**######*#*#*
**#*****###*#**#**##***#**###***
*####*###*###*###*#**####*#*###*
*#**#**#**#*#***###*##**#****#**
*##*#####***###***#*#**###*#*##*
*#**#*#*###***########*#*#*#**#*
*######***#*#****#***###*####*#*
***#**###*########*#*#***#**#*#*
*###*##*****#****#*#######*####*
*#****####*###*#*###***#*###**#*
*####**#*###*###*#*#####**#**##*
*****************.**************
*****************l**************
********************************
