***************
***********e***
*##*##########*
*#****#****#*#*
*#*###########*
*#*#******#****
*#*#*######*##*
*#####***#***#*
*****#*#######*
**####*#*#*****
*##**#***#*###*
****########*#*
**###****#***#*
*##*####*#####*
*#***#*#*******
***#*#***###*#*
**l.######*###*
***************