**************************
*########################*
*#**********************#*
*#*####################*#*
*#*#******************#*#*
*#*#*################*#*#*
*#*#*#*******#******#*#*#*
*#*#*#*############*#*#*#*
*#*#*#*#**********#*#*#*#*
*#*#*#*#*########*#*#*#*#*
*#*#*#*#*#******#*#*#*#*#*
*#*#*#*#*#******###*#*#*#*
*#*#*#*#*#**###*#*#*#*#*#*
*###*#*#*#**#*e*#*#*#*#*#*
*#*#*#*#*#**#***#*#*#*#*#*
*#*#*#*#*#**#***#*#*#*#*#*
*#*#*#*#*########*#*#*#*#*
*#*#*#*#**********#*#*#*#*
*#*#*#*############*#*#*#*
*#*#*#**************#*#*#*
*#*#*################*#*#*
*#*#*****#************#*#*
*#*####################*#*
*#**********************#*
*############.###########*
*************l************
**************************