***********************
***********************
***********************
***************e*******
*****##*##########*****
*****#****#****#*#*****
*****#*###########*****
*****#*#******#********
*****#*#*######*##*****
*****#####***#***#*****
*********#*#######*****
******####*#*#*********
*****##**#***#*###*****
********########*#*****
******###****#***#*****
*****##*####*#####*****
*****#***#*#***********
*******#*#***###*#*****
******l.######*###*****
***********************
***********************
***********************