*************************************
*************************************
*************************************
***###*#########**#*#*###*####**#****
***#*#****#*#**#*######*#***#**##****
***#*#*##***#*####*#**#*###*#*##*****
***#*#**#####****#***####*#######****
***#*##**#########*###*#***##**#*****
***#*###*******#*#*##****#***#*##****
***#*#*#######******#*##########*****
*****#*****#*#*####*#**#**#*##*##****
***###*###*#****#*####*####*****#****
***#*#***####*###**#*#**#**####******
***#*###*#*#***###*#*#*#####**#*#****
*****#*****#*#*#*#*#*#*******####****
***###*#######*#*#######*#*###**#****
***#***#*****#***##******###*##*#e***
***#*###*###*###*#**####**#***##*****
***#***###****##***##**##***#**##****
***###*****##*#**#**##**######**#****
*****######*#######**##*#***#####****
***#**#***###****###**#***#*#***#****
***######*****##*#*##**######*#*#****
****#*****###*#**#**##***#**###******
***####*###*###*###*#**####*#*###****
***#**#**#**#*#***###*##**#****#*****
***##*#####***###***#*#**###*#*##****
***#**#*#*###***########*#*#*#**#****
***######***#*#****#***###*####*#****
*****#**###*########*#*#***#**#*#****
***###*##*****#****#*#######*####****
***#****####*###*#*###***#*###**#****
***####**#*###*###*#*#####**#**##****
*******************.*****************
*******************l*****************
*************************************
*************************************
*************************************